sophisticated - витончений
pretty - гарненька
announce - оголосити
assassination - вбивство
armband - пов'язка
champagne - шампанське
escape - втеча
victim - жертва
breeze  - вітерець
dastardly conspiracy - підла змова
whiff - подих
struggle complicated environment - боротьба з ускладненою обстановкою
dilemma - дилема
pits - ямки
demands - вимоги
struggle - боротьба
mortals - смертні
hubris - зарозумілість
occasion - нагода
involved - залучений
despite - попри
extraordinary - надзвичайний
Instead - Натомість
dazzling - сліпуче
advertising - реклама
so-called off-the-shelf malware - так звані готові шкідливі програми
axiomatic - аксіоматичний
dodgy - хитрий
apartment - квартира
enterprise - підприємство
vulnerable - вразливий
involvement - причетність
accomplished - виконано
roaming - роумінг
interrogated - допитаний
military - військовий
accused - обвинувачений
refugee - біженець
asylum - притулок
seduced - зваблений
convicted of mortgage - засуджений за іпотеку
stable - стійкий
obsession - одержимість
embarrassment - збентеження
wormhole - червоточина
fraudsters - шахраї
prosaically - прозаїчно
Geek - компютерщик(задрот) - Geek - компютерщик(задрот)
Nerd - ботанік - Ботан - ботанік
moral compass - моральний компас
suffers - страждає
tremendous  - величезний
remarkable - чудовий
breed  - порода
rely - покладатися
notion - поняття
opportunity - можливість
milestone - віха
aorta - аорта
wirelessly - бездротовим способом
wireless protocol - бездротовий протокол
wrapped - загорнутий
stuck - застряг
therapies - терапії
disrupted - зірваний
trustworthy - надійний
pressure - тиск
silly - дурний
abandoned - покинутий
victim - жертва
malware - шкідливе програмне забезпечення
astonishing - вражаючий
bunch - пучок
dash - тире
videotaped - знято на відео

